%%%%%%%%%%%%
%..........%
%..........%
%..%..%....%
%...%......%
%...%%.....%
%.....%.%.%%
%.........%%
%%..%......%
%....%..%%.%
%..%%.P..%.%
%.%........%
%.%......%.%
%.......%..%
%.....%%...%
%.%.......%%
%.....%...%%
%........%.%
%.....%...%%
%%%%%%%%%%%%
