
%%%%%%%%%%%%
%.......%..%
%.%.......%%
%......%...%
%..........%
%..%%......%
%.%%%%.....%
%...%.%...%%
%....%.....%
%...%......%
%.....P....%
%..........%
%........%%%
%.%........%
%.....%....%
%%%%...%...%
%..........%
%..........%
%..........%
%%%%%%%%%%%%