
%%%%%%%%%%%%
%.%...%.%..%
%....%.%...%
%..........%
%.......%..%
%......%...%
%...%....%.%
%..........%
%..%.......%
%....%....%%
%....%P....%
%..........%
%%.........%
%.%...%....%
%.%%....%.%%
%....%%...%%
%.....%....%
%..........%
%...%......%
%%%%%%%%%%%%