
%%%%%%%%%%%%
%......%.%.%
%..%....%.%%
%...%.%%%%.%
%..........%
%..%.......%
%..........%
%.........%%
%..........%
%..%......%%
%.%...P....%
%........%.%
%.%.%......%
%......%..%%
%....%%....%
%.%.%....%.%
%.......%.%%
%........%.%
%...%......%
%%%%%%%%%%%%