
%%%%%%%%%%%%
%%.%..%....%
%.%........%
%..........%
%..........%
%..........%
%.....%....%
%.%........%
%.%..%.....%
%..........%
%.....P....%
%..........%
%....%....%%
%..........%
%.....%%...%
%..........%
%..........%
%....%.%...%
%%.........%
%%%%%%%%%%%%