
%%%%%%%%%%%%
%........%.%
%...%...%.%%
%.%...%....%
%..........%
%.......%%.%
%..........%
%.....%.%..%
%.....%....%
%.%........%
%.....P....%
%..........%
%..........%
%.%.%......%
%..........%
%..........%
%..........%
%%.%.......%
%..........%
%%%%%%%%%%%%