
%%%%%%%%%%%%
%...%......%
%.......%..%
%..%.......%
%.........%%
%..........%
%..%.%.....%
%..%.......%
%..%.......%
%.....%.%..%
%.%...P....%
%..........%
%........%.%
%%....%....%
%.....%....%
%.%......%.%
%.........%%
%.........%%
%%...%.....%
%%%%%%%%%%%%