
%%%%%%%%%%%%
%....%.....%
%.%....%...%
%....%%..%.%
%...%......%
%..........%
%..........%
%..........%
%..........%
%.......%%.%
%.....P....%
%%...%.....%
%..........%
%..........%
%.......%..%
%.%....%.%.%
%.......%..%
%..........%
%..........%
%%%%%%%%%%%%