%%%%%%%%%%%%
%      .% %%
% %%%%%%% %%
%       % %%
%%%%% %%%%%%
%   % % % %%
% %%% % % %%
%       %  %
%%% %%%%%%%%
%     P    %
% % %%%%% %%
% % %     %%
% % % %%%%%%
% % % %    %
%%% %%% % %%
%.    % % %%
% % % % % %%
% % % % %  %
%.% %%%%%%%%
%%%%%%%%%%%%
