
%%%%%%%%%%%%
%.      . %%
%        . %
%       %  %
%% %       %
%          %
%   .      %
%        . %
%          %
%      %   %
%     P    %
%         %%
%          %
%    %     %
%    % %   %
%          %
%     %%   %
%%         %
%         %%
%%%%%%%%%%%%