
%%%%%%%%%%%%
%  .       %
%       .  %
%%   .     %
%        . %
%      . % %
%       %  %
%     %%  %%
%      %  %%
%     % %  %
%  %  P    %
%          %
%     %    %
%%         %
%    %     %
%    %     %
%       %  %
%          %
%          %
%%%%%%%%%%%%