
%%%%%%%%%%%%
%..%%...%..%
%..%.......%
%..........%
%...%%.....%
%.%..%.....%
%.%...%%.%.%
%..........%
%.%....%..%%
%%.........%
%.....P....%
%.......%..%
%..%.......%
%........%.%
%...%.%....%
%......%.%%%
%.....%....%
%........%.%
%..........%
%%%%%%%%%%%%