
%%%%%%%%%%%%
%      .   %
%          %
%         .%
% %   .    %
%      %.  %
%          %
% .        %
%     %    %
%  %    %  %
%     P %  %
%          %
%          %
%  %   %   %
%          %
%          %
%          %
%%         %
%          %
%%%%%%%%%%%%