
%%%%%%%%%%%%
%..........%
%...%......%
%..%...%...%
%...%......%
%.......%..%
%.......%..%
%......%.%.%
%......%...%
%......%...%
%.....P....%
%..........%
%..........%
%..........%
%.%...%.%..%
%...%.....%%
%...%......%
%..........%
%......%...%
%%%%%%%%%%%%