
%%%%%%%%%%%%
%.     .   %
%          %
% %.       %
%.      .  %
%          %
% % %      %
%         %%
%    %    %%
%  %       %
%   % P    %
%          %
%    %     %
%%         %
%          %
% %      % %
%      %%  %
%          %
%%         %
%%%%%%%%%%%%