
%%%%%%%%%%%%
%..........%
%..........%
%......%...%
%......%...%
%.....%..%.%
%..........%
%....%%....%
%%.....%...%
%...%......%
%.....P%...%
%...%..%...%
%..........%
%......%..%%
%..........%
%..........%
%.%........%
%....%.....%
%%.........%
%%%%%%%%%%%%