
%%%%%%%%%%%%
%....%....%%
%..........%
%.......%..%
%.%.......%%
%%...%.....%
%.......%..%
%..........%
%....%.%...%
%%%..%.....%
%.%...P....%
%..%...%...%
%.......%.%%
%.%........%
%...%......%
%..........%
%....%%....%
%...%......%
%%..%......%
%%%%%%%%%%%%