
%%%%%%%%%%%%
%    .     %
%   .   .  %
%    %     %
%       .  %
%          %
%  .   %   %
%   %      %
%    % % %%%
% %        %
%     P    %
%      %   %
%          %
%          %
%         %%
% %%      %%
%          %
%   %      %
%          %
%%%%%%%%%%%%