
%%%%%%%%%%%%
%....%..%..%
%..........%
%..........%
%..........%
%..........%
%...%%.....%
%..%..%.%..%
%..........%
%....%.....%
%.....P...%%
%.....%....%
%..........%
%..........%
%..%...%...%
%....%.%...%
%%......%..%
%.....%....%
%..........%
%%%%%%%%%%%%