
%%%%%%%%%%%%
%  .      %%
%   .      %
%        . %
%          %
%          %
%          %
%          %
%        . %
%          %
%  %  P .% %
%          %
%     %  % %
%          %
%    %     %
%          %
%      %   %
%    %     %
%          %
%%%%%%%%%%%%