
%%%%%%%%%%%%
%%.........%
%..........%
%......%...%
%..........%
%.%.....%.%%
%%.........%
%..%.......%
%.........%%
%%.....%...%
%%....P....%
%..........%
%..........%
%....%.....%
%%.......%.%
%....%.%...%
%%.........%
%......%...%
%.....%....%
%%%%%%%%%%%%