
%%%%%%%%%%%%
% . .      %
%        . %
%   .      %
%      .   %
%          %
%      %   %
% %        %
%          %
%          %
%%    P    %
%  %%   %  %
%      %   %
%          %
%          %
%          %
%          %
%     %    %
%          %
%%%%%%%%%%%%