
%%%%%%%%%%%%
%..........%
%%..%%.....%
%%......%..%
%.%%.......%
%.%....%...%
%..%....%..%
%.....%....%
%%.........%
%.....%....%
%.....P....%
%%......%..%
%..........%
%.........%%
%..........%
%......%...%
%.......%..%
%..%...%%..%
%..%.......%
%%%%%%%%%%%%