
%%%%%%%%%%%%
%..%.......%
%.......%..%
%..........%
%..........%
%.....%....%
%%.........%
%.......%..%
%..........%
%..%.%...%.%
%.....P....%
%.........%%
%..........%
%.......%%.%
%...%.....%%
%...%%.....%
%..........%
%......%...%
%..........%
%%%%%%%%%%%%