
%%%%%%%%%%%%
%          %
%  .       %
%   . . .  %
%         %%
%    %     %
%  . % %   %
% %        %
%          %
%          %
%     P %  %
%          %
%         %%
%          %
%       %  %
%  % %%   %%
% % %   %  %
%   %  %  %%
%     %   %%
%%%%%%%%%%%%