
%%%%%%%%%%%%
%..........%
%..%.%...%.%
%..........%
%.%........%
%..........%
%.......%.%%
%..........%
%..%.......%
%.......%..%
%.....P..%.%
%...%....%.%
%%.......%.%
%..........%
%%...%...%.%
%..........%
%..........%
%..........%
%....%..%..%
%%%%%%%%%%%%