
%%%%%%%%%%%%
%..........%
%.........%%
%....%.....%
%..........%
%..........%
%..........%
%....%.....%
%..........%
%.......%..%
%.....P....%
%..........%
%...%....%%%
%..........%
%..........%
%%........%%
%......%...%
%.%........%
%%......%..%
%%%%%%%%%%%%