
%%%%%%%%%%%%
%.........%%
%%.........%
%..........%
%..........%
%.%......%%%
%%......%..%
%.....%....%
%..........%
%..%.......%
%.....P....%
%.%....%%..%
%..........%
%.%........%
%.%........%
%.......%..%
%........%%%
%..........%
%....%...%.%
%%%%%%%%%%%%