
%%%%%%%%%%%%
%%%%......%%
%..........%
%......%...%
%..........%
%.%...%....%
%.%........%
%...%%..%..%
%%..%......%
%..%.......%
%.....P.%..%
%.........%%
%..........%
%..........%
%.%..%.....%
%..%%...%..%
%..%.......%
%.........%%
%......%...%
%%%%%%%%%%%%