
%%%%%%%%%%%%
%          %
% . .      %
%   %.. .  %
% %   %   %%
%%    %    %
%     %    %
%          %
%  %%      %
%          %
%     P    %
%          %
%          %
%          %
%        % %
%     %    %
%     %   %%
%%        %%
%          %
%%%%%%%%%%%%