
%%%%%%%%%%%%
%%.........%
%..........%
%....%%.%.%%
%....%.....%
%.....%.%.%%
%..........%
%..........%
%%....%.%..%
%.......%..%
%.....P.%..%
%....%.....%
%...%%.%...%
%...%......%
%.......%.%%
%....%%%...%
%.%........%
%.....%....%
%....%.....%
%%%%%%%%%%%%