
%%%%%%%%%%%%
%..........%
%..........%
%....%.....%
%........%.%
%%.........%
%.........%%
%......%...%
%..........%
%......%...%
%.....P....%
%....%.....%
%...%......%
%%.%.......%
%..........%
%.......%..%
%%....%....%
%.%........%
%....%....%%
%%%%%%%%%%%%