
%%%%%%%%%%%%
%....%.%...%
%...%......%
%.%..%.....%
%..%.......%
%..........%
%..%.......%
%.........%%
%..%.......%
%.%........%
%..%.%P....%
%%.%..%..%.%
%.........%%
%.........%%
%..........%
%......%.%.%
%..........%
%..........%
%%.........%
%%%%%%%%%%%%