
%%%%%%%%%%%%
%  %    %  %
%       %  %
%%.        %
%         .%
%          %
%          %
%     %%   %
% %   .    %
%%    % .  %
%   . P    %
%        % %
%        % %
%          %
%  %       %
%        % %
%          %
%%  %    % %
%  %       %
%%%%%%%%%%%%