
%%%%%%%%%%%%
%....%.....%
%........%.%
%..........%
%..........%
%..........%
%..........%
%..........%
%..........%
%%.......%.%
%.%.%.P....%
%..........%
%..........%
%....%.....%
%....%.....%
%...%......%
%........%.%
%...%......%
%..........%
%%%%%%%%%%%%