
%%%%%%%%%%%%
%  .       %
%       .  %
%   .    . %
%  .%      %
%    %   % %
%   %      %
%      %   %
%       %  %
%          %
%     P    %
%          %
%          %
%        %%%
%          %
%          %
%          %
%    %     %
%          %
%%%%%%%%%%%%