
%%%%%%%%%%%%
%....%.%...%
%%%........%
%.%........%
%....%.....%
%%..%......%
%.%.......%%
%.%.%....%%%
%..........%
%....%.....%
%.....P....%
%%.........%
%%.%.......%
%.........%%
%........%%%
%.%.%...%..%
%.........%%
%..........%
%...%.%....%
%%%%%%%%%%%%