
%%%%%%%%%%%%
% %  .  .  %
%          %
%.         %
%          %
%      .   %
%     %    %
%      %  .%
%          %
%          %
% %   P% % %
%    %   % %
%%         %
%    %     %
%          %
%          %
%    %  %  %
%  %       %
%%%        %
%%%%%%%%%%%%