
%%%%%%%%%%%%
%.%..%.....%
%..........%
%........%%%
%.........%%
%..........%
%.........%%
%..........%
%..........%
%...%%..%..%
%.....P.%..%
%..........%
%.%.......%%
%%.%.......%
%..%.......%
%%.........%
%%.........%
%..........%
%.....%....%
%%%%%%%%%%%%