
%%%%%%%%%%%%
%..........%
%....%.....%
%......%.%.%
%%.%.......%
%..........%
%..%..%....%
%..........%
%%....%....%
%....%%.%..%
%...%.P....%
%..........%
%.........%%
%.......%%.%
%..........%
%..........%
%.......%..%
%..%.......%
%..%.......%
%%%%%%%%%%%%