
%%%%%%%%%%%%
%          %
%.        .%
%  .%    . %
%       .  %
%          %
%       %  %
%          %
%          %
%          %
%%  % P    %
%       % %%
%          %
% % %      %
%          %
%          %
%          %
%          %
% %        %
%%%%%%%%%%%%