
%%%%%%%%%%%%
%          %
%       .  %
%         .%
%  .   .  %%
%    .%    %
%%         %
%   %   %  %
%    %%    %
%         %%
%     P    %
%          %
%%     %   %
%          %
%          %
%  %       %
% %  %%  % %
% %   %    %
%%         %
%%%%%%%%%%%%