
%%%%%%%%%%%%
%..%.......%
%..........%
%..........%
%..........%
%..........%
%.%..%.....%
%%........%%
%........%.%
%....%...%.%
%%....P....%
%.......%..%
%..........%
%..........%
%..........%
%.%........%
%..........%
%.........%%
%..........%
%%%%%%%%%%%%