
%%%%%%%%%%%%
%        % %
%          %
%          %
%    .     %
%.   .     %
%   . .    %
%      %   %
%%         %
%          %
%    %P  % %
%%         %
%          %
%%         %
%          %
%         %%
%       %  %
%      %   %
%          %
%%%%%%%%%%%%