
%%%%%%%%%%%%
%...%......%
%......%...%
%%.%.......%
%.%........%
%....%....%%
%.........%%
%......%...%
%...%....%.%
%.......%..%
%....%P....%
%%.........%
%..........%
%..%..%....%
%..%.......%
%.....%....%
%........%.%
%..........%
%..%....%..%
%%%%%%%%%%%%