
%%%%%%%%%%%%
%...%......%
%........%.%
%...%.%..%.%
%..%.......%
%.%..%.....%
%.....%....%
%..........%
%..........%
%..........%
%...%.P.%..%
%..%.......%
%%.........%
%....%%....%
%...%......%
%..........%
%....%.....%
%.........%%
%%.........%
%%%%%%%%%%%%