
%%%%%%%%%%%%
%..........%
%..........%
%..%.......%
%....%.....%
%%%%.......%
%..........%
%..........%
%...%.....%%
%%.........%
%.....P....%
%....%.....%
%..........%
%....%.....%
%..........%
%..........%
%......%...%
%.....%...%%
%.%........%
%%%%%%%%%%%%