
%%%%%%%%%%%%
%       %  %
%  .       %
%   %      %
%   .      %
%          %
%          %
%.         %
%    .     %
%  .%      %
% %   P    %
%          %
%          %
%          %
%%    %    %
%          %
%  %       %
%          %
%          %
%%%%%%%%%%%%