
%%%%%%%%%%%%
%  .       %
%    %%    %
%          %
%  ..      %
%          %
%        . %
%          %
% .        %
%          %
%     P%   %
%          %
%          %
%          %
%          %
%   %    % %
%          %
%          %
%          %
%%%%%%%%%%%%