
%%%%%%%%%%%%
%    .     %
%          %
%. ...   % %
% %        %
%     %    %
%          %
%      %   %
%          %
%          %
%    %P    %
%%%%    %  %
%          %
%  %       %
%          %
%%         %
%   %    % %
%    %     %
%          %
%%%%%%%%%%%%