
%%%%%%%%%%%%
% .  .     %
%  %       %
%          %
%   %   .  %
% .        %
%          %
%    %     %
%.         %
%          %
%  %  P    %
%          %
%          %
%      %   %
%   % %    %
%          %
%          %
%        % %
%          %
%%%%%%%%%%%%