
%%%%%%%%%%%%
%.....%..%.%
%.......%..%
%..........%
%..........%
%....%.....%
%..........%
%..........%
%..........%
%..........%
%.....P....%
%.......%..%
%..........%
%..........%
%..........%
%..........%
%..........%
%..........%
%........%.%
%%%%%%%%%%%%