
%%%%%%%%%%%%
%%.........%
%..........%
%........%.%
%.......%..%
%.........%%
%..........%
%..........%
%%..%.....%%
%..........%
%.....P....%
%%.........%
%.%..%.....%
%..........%
%..........%
%........%.%
%.........%%
%......%.%.%
%..........%
%%%%%%%%%%%%