
%%%%%%%%%%%%
%          %
%   %.     %
%.    .   %%
%.         %
%       %  %
% .        %
%    %   % %
%         %%
%          %
%     P    %
%     %   %%
%          %
%   %      %
%  %       %
%   %      %
%          %
%%         %
%      %   %
%%%%%%%%%%%%