
%%%%%%%%%%%%
%       . .%
%      . %.%
%.     %   %
%       %  %
%          %
%          %
%%   %%    %
%%         %
%       %  %
% %%  P    %
%      %%  %
%    %     %
%       %  %
%        % %
%          %
%%         %
%          %
%         %%
%%%%%%%%%%%%