
%%%%%%%%%%%%
%.%.....%..%
%.........%%
%.....%....%
%..%%......%
%..........%
%...%......%
%..%.......%
%.%%.......%
%..........%
%.....P....%
%.%.%..%...%
%...%...%..%
%..........%
%...%......%
%.........%%
%....%...%.%
%..........%
%.%.....%..%
%%%%%%%%%%%%