
%%%%%%%%%%%%
%......%..%%
%.%%%.....%%
%.....%....%
%...%......%
%........%.%
%..........%
%%.....%...%
%....%.%%..%
%......%%..%
%.%.%.P....%
%.....%....%
%..........%
%..%.......%
%..........%
%.%........%
%..........%
%..........%
%....%.%...%
%%%%%%%%%%%%