
%%%%%%%%%%%%
%     %   %%
%       .. %
%   .      %
%    %     %
%          %
%          %
%      %   %
%   .  . % %
%          %
%     P    %
%          %
%          %
%   %      %
%     %    %
%       %  %
%      %   %
%     %    %
%   %      %
%%%%%%%%%%%%