
%%%%%%%%%%%%
%          %
%          %
%%         %
% %  %.    %
%          %
% .    .   %
%          %
%      .%  %
%%%        %
% .   P %  %
%%     %   %
%    %     %
%          %
%          %
%          %
%     %%   %
%         %%
%        % %
%%%%%%%%%%%%