
%%%%%%%%%%%%
%       .  %
%          %
%          %
%%     %   %
%  .       %
%  .     . %
%          %
%     .    %
%     %   %%
%     P  % %
%          %
%          %
%          %
%         %%
%%         %
%    %     %
%       %  %
%          %
%%%%%%%%%%%%