
%%%%%%%%%%%%
%          %
%    %     %
%.       . %
% . %      %
%          %
% %  .     %
%  %     . %
%   %     %%
% %   %    %
%     P %  %
%          %
%    %     %
%          %
%          %
%          %
%          %
%    %     %
%       %  %
%%%%%%%%%%%%