
%%%%%%%%%%%%
% .   .    %
%          %
% .        %
%         %%
% .        %
%  %     . %
%          %
%          %
%          %
%    %P    %
%          %
%   %      %
%       %  %
%   %      %
%          %
%          %
%       %  %
%  %     % %
%%%%%%%%%%%%