
%%%%%%%%%%%%
%         .%
%    .     %
%  %       %
%    .     %
%          %
%%         %
%     .    %
%          %
%  .       %
% %   P    %
%          %
%          %
%        % %
%          %
%       %  %
%        % %
%  % %    %%
% %    %   %
%%%%%%%%%%%%