
%%%%%%%%%%%%
%..........%
%...%......%
%......%...%
%..........%
%........%.%
%.......%..%
%%.........%
%........%.%
%...%%.%...%
%.....P%..%%
%..........%
%%.........%
%........%.%
%.....%....%
%..%.......%
%%..%......%
%..........%
%%.........%
%%%%%%%%%%%%