
%%%%%%%%%%%%
%         .%
%   . .    %
%   .      %
%  .       %
%        % %
%      %   %
%          %
%          %
%          %
%   % P%   %
%          %
%  %       %
%          %
% %        %
%         %%
% %        %
%         %%
%   %  %   %
%%%%%%%%%%%%