
%%%%%%%%%%%%
%     .    %
%  .       %
%          %
%    %%    %
%       ..%%
%       .  %
%    %     %
%  %       %
%       %  %
%     P %  %
%          %
%         %%
%          %
%          %
%          %
%          %
%         %%
% %%       %
%%%%%%%%%%%%