
%%%%%%%%%%%%
%          %
%          %
%          %
%%         %
% .        %
%     .  %.%
%  ..      %
%     %    %
%          %
% %   P%%  %
%%%     %  %
%       %% %
% %        %
%%       % %
%          %
%       %  %
%  %       %
%          %
%%%%%%%%%%%%