
%%%%%%%%%%%%
%          %
%          %
% %       .%
% .    .   %
% .        %
%   .      %
%          %
%          %
%     %  % %
%     P    %
%        % %
%          %
%          %
%        %%%
%      % % %
%         %%
%          %
% %%      %%
%%%%%%%%%%%%