
%%%%%%%%%%%%
%       .  %
%          %
%       %  %
%       .  %
%          %
%          %
%         .%
%     %    %
%      %   %
%     P    %
%          %
% %        %
%.%        %
%         .%
%         %%
%        % %
%  %       %
%       %  %
%%%%%%%%%%%%