
%%%%%%%%%%%%
%  ...     %
%       %  %
%       .  %
%   .      %
%          %
%          %
%          %
%          %
%   %      %
%     P    %
%  %       %
%          %
%%         %
%          %
%   %      %
%          %
%          %
%          %
%%%%%%%%%%%%