
%%%%%%%%%%%%
%     . .  %
%    . %   %
%      .   %
% %   % %  %
%       %  %
%          %
%          %
%.         %
%      % % %
%%    P    %
%     %    %
%  %       %
%         %%
%          %
%  %       %
%   %      %
%       %  %
%  %       %
%%%%%%%%%%%%