
%%%%%%%%%%%%
%          %
%.         %
%%         %
%          %
%     .    %
%     .    %
%          %
%    %     %
%     . .  %
%     P    %
%          %
%          %
%%         %
%        % %
%      %  %%
%          %
% %       %%
%      %   %
%%%%%%%%%%%%