
%%%%%%%%%%%%
%%.....%..%%
%..........%
%...%.%....%
%........%.%
%..%....%..%
%..........%
%..........%
%.....%....%
%%....%....%
%.%.%.P.%..%
%..........%
%.....%%%.%%
%..........%
%%.........%
%..%.......%
%%.......%.%
%....%.....%
%.......%..%
%%%%%%%%%%%%