
%%%%%%%%%%%%
%..........%
%..........%
%..........%
%...%%.%...%
%......%...%
%.........%%
%..........%
%...%%%....%
%..%.....%%%
%.....P....%
%..........%
%..........%
%%...%.....%
%..........%
%..%.......%
%....%.....%
%..........%
%....%%....%
%%%%%%%%%%%%