
%%%%%%%%%%%%
%          %
%  .       %
%        % %
%  . .     %
%          %
%    .    .%
%%     %   %
%    %     %
%        % %
%     P% % %
% %        %
%          %
%      % % %
%          %
%    %     %
%%   %     %
%    % %   %
%          %
%%%%%%%%%%%%