
%%%%%%%%%%%%
%..........%
%....%.....%
%.........%%
%..........%
%..........%
%..%......%%
%..%....%..%
%..%.......%
%.%........%
%.....P..%%%
%..........%
%..%.%%.%..%
%....%%....%
%.....%.%..%
%..........%
%..........%
%.%....%...%
%..........%
%%%%%%%%%%%%