
%%%%%%%%%%%%
%  .       %
%       .  %
%         .%
%      . % %
%  .       %
%          %
%          %
%      %   %
%          %
%   % P %  %
%  % %     %
% %  %% %  %
%        % %
%         %%
% %  %  % %%
%          %
%   %  %   %
% %        %
%%%%%%%%%%%%