
%%%%%%%%%%%%
%%.%......%%
%..%....%..%
%...%%.....%
%..........%
%........%.%
%..........%
%..........%
%..%.%....%%
%..........%
%.....P....%
%..........%
%%.%......%%
%.......%..%
%......%...%
%..........%
%%.....%...%
%.....%...%%
%...%......%
%%%%%%%%%%%%