
%%%%%%%%%%%%
%.....%..%.%
%...%......%
%..........%
%.......%..%
%..........%
%.%..%...%.%
%..........%
%.....%..%.%
%.........%%
%..%..P...%%
%..%.......%
%%......%..%
%%......%.%%
%....%.%..%%
%..........%
%..%.......%
%..........%
%..........%
%%%%%%%%%%%%