
%%%%%%%%%%%%
%..%.%.....%
%..........%
%....%.....%
%........%.%
%..........%
%...%.%..%.%
%.....%....%
%......%...%
%..........%
%.....P....%
%.....%....%
%......%...%
%..........%
%%.........%
%......%%..%
%.......%..%
%..........%
%..........%
%%%%%%%%%%%%