
%%%%%%%%%%%%
%%         %
% .        %
%    . % . %
%          %
%      %  %%
%          %
%          %
%          %
%          %
%    %P    %
%  .       %
%          %
%.%%       %
%          %
%   %      %
% %        %
%          %
%%         %
%%%%%%%%%%%%