
%%%%%%%%%%%%
%..%.....%.%
%...%......%
%..........%
%..%.......%
%..........%
%..........%
%......%%..%
%%.....%.%.%
%%...%.....%
%.....P....%
%..%.......%
%.........%%
%....%..%..%
%......%.%.%
%..........%
%.........%%
%..........%
%..........%
%%%%%%%%%%%%