
%%%%%%%%%%%%
%  .       %
%  .       %
%          %
%        . %
%   . %    %
%  %       %
%          %
%  .       %
%%     %   %
%     P    %
% %%       %
%    %     %
%          %
%          %
%       %  %
%    %     %
%       %  %
%          %
%%%%%%%%%%%%