
%%%%%%%%%%%%
%.........%%
%..........%
%......%...%
%..%%..%...%
%..%.......%
%.%........%
%..%.......%
%..%.......%
%........%.%
%..%.%P..%.%
%......%...%
%%.........%
%......%...%
%.......%..%
%..%.......%
%%........%%
%....%.....%
%........%.%
%%%%%%%%%%%%