
%%%%%%%%%%%%
%..........%
%..%.%.....%
%..%.......%
%..%.......%
%..%.......%
%....%.....%
%.......%..%
%.......%%.%
%......%...%
%.%.%.P..%%%
%..........%
%.......%.%%
%%%.....%..%
%..%.......%
%.%........%
%..........%
%..........%
%...%...%..%
%%%%%%%%%%%%