
%%%%%%%%%%%%
%%.%.....%%%
%..........%
%....%.....%
%....%....%%
%...%......%
%..........%
%..........%
%..........%
%.........%%
%....%P....%
%.%....%%..%
%%.......%.%
%....%%....%
%.......%..%
%..........%
%.%%.%.....%
%..%.....%.%
%..........%
%%%%%%%%%%%%