
%%%%%%%%%%%%
%      .   %
%   %      %
% .        %
%          %
%..   .    %
%   %      %
%          %
%          %
%%         %
%     P    %
%   % %    %
%          %
%   %      %
%          %
%          %
% %        %
%          %
%%     %  %%
%%%%%%%%%%%%