
%%%%%%%%%%%%
%..........%
%..........%
%..........%
%..........%
%...%......%
%..%.......%
%.....%....%
%...%.%....%
%.....%....%
%.....P....%
%..........%
%..........%
%%...%.....%
%........%.%
%%....%....%
%..........%
%..%.....%.%
%..........%
%%%%%%%%%%%%