
%%%%%%%%%%%%
%          %
% . .      %
%          %
%    % .  .%
%        . %
%          %
%   %      %
%  %       %
%%         %
%     P    %
%          %
%  %%      %
%   %      %
%%         %
%       %  %
%          %
%          %
%     %%   %
%%%%%%%%%%%%