
%%%%%%%%%%%%
%.......%%.%
%........%.%
%....%.....%
%..........%
%%......%..%
%....%.....%
%..........%
%....%.....%
%..%%......%
%.....P....%
%......%...%
%.....%%...%
%.%........%
%..........%
%%.....%...%
%..........%
%.%..%.....%
%..........%
%%%%%%%%%%%%