
%%%%%%%%%%%%
%          %
%   %.    %%
%          %
%      .   %
%   .  %   %
%          %
%       . .%
%          %
%    %%    %
%     P%   %
%          %
%          %
% % %%     %
%          %
%          %
%     %    %
%  %       %
%          %
%%%%%%%%%%%%