
%%%%%%%%%%%%
%....%%....%
%....%%....%
%..........%
%..........%
%..........%
%..........%
%...%.%....%
%...%......%
%.........%%
%.....P....%
%.........%%
%...%%....%%
%.......%.%%
%.....%...%%
%.........%%
%......%%..%
%..........%
%.%........%
%%%%%%%%%%%%