
%%%%%%%%%%%%
%%%....%..%%
%..........%
%..........%
%........%.%
%....%.....%
%.%........%
%.....%....%
%..........%
%...%.%....%
%.....P...%%
%..........%
%..%.......%
%....%.%.%.%
%........%.%
%..%.......%
%..........%
%..........%
%...%......%
%%%%%%%%%%%%