
%%%%%%%%%%%%
%.....%....%
%.%........%
%.....%....%
%...%%.....%
%%%.....%..%
%..........%
%.......%..%
%..........%
%.........%%
%..%..P....%
%.....%....%
%....%.....%
%.........%%
%.%........%
%..........%
%.%........%
%..........%
%%......%..%
%%%%%%%%%%%%