
%%%%%%%%%%%%
%          %
%.   %     %
%      .   %
%          %
%    .    .%
%        % %
%          %
% %       .%
%          %
%     P    %
%     %    %
%          %
%          %
%    %   % %
%   %   % %%
%  %       %
%          %
%          %
%%%%%%%%%%%%