
%%%%%%%%%%%%
%     %    %
%          %
%    .   . %
%    %  %  %
%          %
%   . %    %
% .       .%
%    % %   %
%  %       %
% %   P    %
%       % %%
%%         %
%          %
%          %
%%% %      %
%          %
%   %      %
%          %
%%%%%%%%%%%%