
%%%%%%%%%%%%
%%         %
%   .  .   %
%   %    . %
%  . %     %
%      %.  %
%          %
%%         %
%    %     %
%   %      %
%% %  P %  %
%%     %   %
%     %  % %
%         %%
%          %
%  %       %
%          %
%          %
%%       % %
%%%%%%%%%%%%