
%%%%%%%%%%%%
%........%.%
%.....%....%
%..........%
%......%...%
%%%........%
%......%...%
%.%........%
%.%..%..%..%
%....%%....%
%..%..P....%
%..........%
%..%.....%.%
%..........%
%....%%....%
%..%.....%.%
%..........%
%..........%
%..........%
%%%%%%%%%%%%