
%%%%%%%%%%%%
%..........%
%.....%.%..%
%..........%
%..........%
%%%....%...%
%.%........%
%....%.....%
%..%.......%
%........%.%
%%...%P....%
%..........%
%.......%%.%
%.%.%......%
%....%.....%
%..%.%.....%
%%.........%
%....%.....%
%..........%
%%%%%%%%%%%%