
%%%%%%%%%%%%
%    .  .  %
%   .      %
%        % %
% .        %
%        . %
%   %      %
%          %
%%      %% %
%          %
%     P    %
%    %  %  %
%  % %     %
%         %%
%          %
%          %
%  %       %
%          %
% %        %
%%%%%%%%%%%%