
%%%%%%%%%%%%
%.    %    %
%    .     %
%    %     %
%          %
%          %
%     %  ..%
%          %
%    .   % %
%      %   %
%     P    %
% %        %
%          %
%          %
%  %   %   %
%%         %
%        %%%
%          %
%  %     % %
%%%%%%%%%%%%