
%%%%%%%%%%%%
% .     %  %
%   .     %%
%     .  . %
%     .%   %
%  %    %% %
%  %  %    %
%   % %   %%
%      %   %
% %      % %
% %  %P    %
%    %     %
%          %
%        % %
%          %
%          %
%     %    %
%%         %
%       %  %
%%%%%%%%%%%%