
%%%%%%%%%%%%
%          %
%  %  % .. %
%          %
%. .       %
%   .%     %
%          %
%          %
%   %      %
%          %
%     P    %
%       %  %
%          %
%%         %
% %% %     %
%          %
%          %
%%%        %
%         %%
%%%%%%%%%%%%