
%%%%%%%%%%%%
%..%...%%..%
%....%..%..%
%%.........%
%..%.......%
%..%..%....%
%..%.......%
%..........%
%..........%
%.%%......%%
%.....P....%
%.......%..%
%%.%.......%
%%........%%
%....%.....%
%%.........%
%.%........%
%.......%%.%
%.....%....%
%%%%%%%%%%%%