
%%%%%%%%%%%%
%          %
%.  %      %
%  . .     %
%%         %
%         %%
%          %
%          %
%          %
%          %
%     P    %
%          %
%  .   %   %
%       .  %
%    %%%   %
%%         %
%          %
%      %   %
%  %       %
%%%%%%%%%%%%