
%%%%%%%%%%%%
%  ..      %
%      %   %
%         .%
%    %     %
%          %
%%         %
%        . %
%    %     %
%        . %
% %   P    %
%          %
%          %
%   %      %
%      %   %
%   %      %
%    %  %  %
%%         %
%        % %
%%%%%%%%%%%%