
%%%%%%%%%%%%
%%.%.......%
%........%.%
%......%...%
%......%...%
%.....%....%
%........%%%
%.%.%......%
%..........%
%..........%
%.....P....%
%..........%
%%.....%%..%
%......%..%%
%......%...%
%%.........%
%%.%....%..%
%..........%
%..........%
%%%%%%%%%%%%