
%%%%%%%%%%%%
% .    .   %
%          %
%       . %%
%    .     %
%          %
%.     %  %%
%          %
%          %
%   %      %
%     P    %
%     %   %%
%          %
%       % %%
%          %
%   %      %
%         %%
% %%       %
%         %%
%%%%%%%%%%%%