
%%%%%%%%%%%%
%%.....%...%
%..........%
%.....%....%
%.....%....%
%.%..%.%%..%
%..........%
%..........%
%.%...%....%
%.....%%...%
%....%P....%
%....%.%...%
%.....%%...%
%..%.....%.%
%..%.....%.%
%.......%..%
%..........%
%..........%
%..........%
%%%%%%%%%%%%