
%%%%%%%%%%%%
%.         %
%          %
%%         %
%         %%
%         .%
%      % . %
%%.      % %
%          %
%          %
%     P . %%
%      %   %
%          %
%          %
%    %     %
%          %
% %        %
% %        %
%       %  %
%%%%%%%%%%%%