
%%%%%%%%%%%%
%..........%
%.....%%...%
%......%...%
%.%.%......%
%..%%%.....%
%..........%
%%.....%...%
%......%...%
%.......%%.%
%.....P....%
%%....%....%
%.......%%.%
%.....%...%%
%..........%
%.....%....%
%..........%
%..%.......%
%%.....%...%
%%%%%%%%%%%%