
%%%%%%%%%%%%
%..........%
%..........%
%.....%%...%
%..%.......%
%%.........%
%..%.......%
%..........%
%........%.%
%....%.....%
%.....P.%%.%
%..%.......%
%..........%
%%.........%
%..........%
%..%.....%.%
%..%.......%
%........%.%
%...%......%
%%%%%%%%%%%%