
%%%%%%%%%%%%
%..........%
%%.........%
%..........%
%........%.%
%..........%
%..........%
%..........%
%.%........%
%..........%
%....%P%...%
%......%...%
%.....%....%
%........%.%
%..........%
%..........%
%..........%
%..........%
%..........%
%%%%%%%%%%%%