
%%%%%%%%%%%%
%       %  %
%   .. .   %
%          %
%     .   %%
%  .       %
%   %   %  %
%          %
%        % %
%          %
%     P%   %
%          %
%   %      %
%          %
%          %
%       %% %
%          %
%          %
%    % %  %%
%%%%%%%%%%%%