
%%%%%%%%%%%%
%..........%
%...%..%...%
%.%......%%%
%..%.......%
%.%..%%.%%.%
%........%.%
%.....%....%
%%...%.....%
%..........%
%.....P....%
%..........%
%%..%......%
%....%%....%
%..........%
%..........%
%......%...%
%..........%
%.........%%
%%%%%%%%%%%%