
%%%%%%%%%%%%
%......%.%.%
%..%.....%.%
%..........%
%..%....%..%
%.........%%
%........%.%
%....%.....%
%....%.....%
%%.%..%%...%
%.%%..P.%..%
%........%%%
%..........%
%..........%
%..........%
%.%.......%%
%%.........%
%..........%
%.....%....%
%%%%%%%%%%%%