
%%%%%%%%%%%%
%  .      .%
%  .  .  . %
%         %%
%          %
%          %
%         %%
%          %
%          %
%%         %
%     P    %
%  %    %  %
%          %
%        % %
%%         %
%    %     %
%%         %
% %   %    %
%%         %
%%%%%%%%%%%%