
%%%%%%%%%%%%
%        . %
%          %
%      . . %
%    .  % .%
%          %
%          %
%          %
%  %       %
%%         %
%     P    %
%   %      %
%          %
%       %  %
%          %
%     % %  %
%        % %
%    %     %
%          %
%%%%%%%%%%%%