
%%%%%%%%%%%%
%   .      %
%        %.%
%        %%%
%          %
%        . %
%. %       %
%          %
% %        %
%      .   %
%     P    %
%         %%
%   %      %
% %  %     %
%%         %
%     %    %
%%     %   %
%   %  %   %
%       %% %
%%%%%%%%%%%%