
%%%%%%%%%%%%
%          %
%       .. %
%          %
%          %
% .        %
%     .    %
%.      %  %
%          %
%          %
%     P    %
%   %     %%
%          %
%    %     %
%      %   %
%          %
%          %
%        % %
%          %
%%%%%%%%%%%%