
%%%%%%%%%%%%
%%.%.%.%...%
%..........%
%..........%
%....%.....%
%..........%
%..........%
%..%.......%
%....%.....%
%..........%
%.%...P....%
%..........%
%.......%..%
%..........%
%..........%
%......%...%
%..........%
%.....%...%%
%...%......%
%%%%%%%%%%%%