
%%%%%%%%%%%%
%.         %
% .  ..    %
%%   .     %
%  %       %
%        % %
%  %       %
%    %  %  %
%  %       %
%  % %     %
%     P    %
%%%  %     %
%       %  %
%          %
%          %
%    %     %
%         %%
%          %
%      %   %
%%%%%%%%%%%%