
%%%%%%%%%%%%
%..........%
%%.........%
%........%.%
%.......%..%
%..........%
%..........%
%...%......%
%..........%
%...%......%
%.....P....%
%.........%%
%..........%
%%.%.......%
%.%........%
%.....%.%%.%
%........%.%
%%%%.......%
%..........%
%%%%%%%%%%%%