
%%%%%%%%%%%%
%          %
%     .    %
%.         %
%     .  . %
% .        %
%          %
%          %
%          %
%          %
%     P    %
%          %
%       %  %
%  %    %  %
%        % %
%       %  %
%  %%      %
%%   %     %
%          %
%%%%%%%%%%%%