
%%%%%%%%%%%%
%          %
%         .%
%          %
%     .    %
%          %
%       %  %
%%%        %
%     .   .%
% .       %%
%     P    %
% %        %
%     %    %
%          %
%          %
% %        %
%   %      %
%   %      %
%       % %%
%%%%%%%%%%%%