
%%%%%%%%%%%%
%.%....%%..%
%..%.......%
%......%...%
%...%..%...%
%.......%..%
%..........%
%.........%%
%..........%
%..%%..%...%
%....%P.%..%
%....%...%%%
%......%..%%
%..........%
%..........%
%%.........%
%....%.....%
%.%........%
%.....%....%
%%%%%%%%%%%%