
%%%%%%%%%%%%
%........%.%
%.....%.%..%
%......%...%
%...%......%
%..........%
%..........%
%.%........%
%........%.%
%..........%
%.....P....%
%..%.......%
%..%.......%
%.......%..%
%..%....%..%
%..........%
%...%.%....%
%.%........%
%..%%......%
%%%%%%%%%%%%