
%%%%%%%%%%%%
%..........%
%..%.......%
%.....%....%
%..........%
%....%.....%
%..........%
%%......%..%
%..........%
%..........%
%.....P....%
%..........%
%%..%.....%%
%..........%
%.....%%...%
%.%........%
%..%..%...%%
%.%...%%.%.%
%.%........%
%%%%%%%%%%%%