
%%%%%%%%%%%%
%..%..%....%
%.......%..%
%..........%
%..........%
%...%......%
%...%.%....%
%.%...%....%
%..%.....%.%
%.......%%.%
%.....P....%
%.......%..%
%%.........%
%%.........%
%..........%
%%...%.....%
%..........%
%..........%
%%.........%
%%%%%%%%%%%%