
%%%%%%%%%%%%
%.......%..%
%.%........%
%.........%%
%..........%
%....%.....%
%..........%
%........%.%
%%..%......%
%.......%..%
%%....P....%
%.%........%
%........%.%
%..%.......%
%%.........%
%..........%
%..........%
%.....%.%..%
%..........%
%%%%%%%%%%%%