
%%%%%%%%%%%%
%.........%%
%%.......%.%
%..........%
%..%..%.%..%
%...%......%
%..........%
%......%...%
%..........%
%..%.%.....%
%.....P....%
%%.%.......%
%..........%
%...%......%
%..........%
%..........%
%...%......%
%.....%.%%%%
%..........%
%%%%%%%%%%%%