
%%%%%%%%%%%%
% . %      %
%          %
% %        %
%          %
%     %    %
%         %%
%  .       %
%        ..%
%.         %
%     P    %
%         %%
%    %     %
%%         %
%          %
%        % %
%          %
% %%   %   %
%        % %
%%%%%%%%%%%%