
%%%%%%%%%%%%
%          %
%    .    .%
%    %     %
%  . .    .%
%          %
%          %
%          %
%    %     %
%          %
%%    P%   %
%   %      %
%%         %
% %      % %
%          %
%          %
%          %
%   %    % %
%          %
%%%%%%%%%%%%