
%%%%%%%%%%%%
%....%.....%
%..........%
%..........%
%..%.....%.%
%........%.%
%....%.....%
%....%%%...%
%.........%%
%.%........%
%.....P....%
%..........%
%..........%
%....%.....%
%.........%%
%.%........%
%..........%
%.........%%
%..........%
%%%%%%%%%%%%