
%%%%%%%%%%%%
%         .%
%    . .  .%
% .        %
%          %
%        % %
%          %
%    % %   %
%          %
%     %   %%
%     P    %
%   %      %
%   %      %
%         %%
%  %       %
%          %
%          %
%          %
%          %
%%%%%%%%%%%%