
%%%%%%%%%%%%
% .   .    %
%   . .    %
%    .     %
%%        %%
%       %  %
%          %
%  %       %
%    %     %
%    %     %
% %   P    %
%          %
%       % %%
%          %
%      %   %
%          %
%      %  %%
%          %
%          %
%%%%%%%%%%%%