
%%%%%%%%%%%%
%..%.......%
%.......%..%
%%.........%
%..%....%..%
%........%.%
%.......%..%
%..........%
%.......%..%
%%...%%%...%
%%....P.%..%
%..........%
%..........%
%....%....%%
%..........%
%..........%
%...%......%
%..........%
%..%.......%
%%%%%%%%%%%%