
%%%%%%%%%%%%
%          %
%          %
%          %
% %        %
%      ..  %
%          %
%          %
%  .       %
%          %
%     P .  %
%   % %    %
%   . %    %
%        % %
%        % %
%  %       %
%          %
%          %
%   % %    %
%%%%%%%%%%%%