
%%%%%%%%%%%%
%%..%.%....%
%...%......%
%.......%%.%
%%.........%
%%.........%
%..%..%....%
%...%......%
%........%.%
%.%%..%..%.%
%.....P...%%
%.........%%
%..........%
%....%...%.%
%.........%%
%..........%
%.....%....%
%.......%..%
%..........%
%%%%%%%%%%%%