
%%%%%%%%%%%%
%        ..%
%          %
% .    .   %
%          %
%       .  %
%          %
%          %
%    %%    %
%  %     % %
%  %  P    %
%          %
%          %
%    %     %
%          %
%     %    %
%   %%     %
%          %
%          %
%%%%%%%%%%%%