
%%%%%%%%%%%%
% .        %
%. .       %
%  %       %
%   . .    %
%          %
%          %
%%         %
%%         %
%  %       %
%     P    %
%         %%
%          %
%    %     %
%          %
% % %    % %
%       % %%
%          %
%       %  %
%%%%%%%%%%%%