
%%%%%%%%%%%%
%.%....%..%%
%..........%
%..%..%....%
%..........%
%..........%
%..........%
%..........%
%.......%..%
%........%.%
%..%.%P....%
%%....%....%
%...%......%
%......%...%
%..%.....%.%
%.%........%
%........%.%
%%.........%
%.........%%
%%%%%%%%%%%%