
%%%%%%%%%%%%
%...%....%%%
%.......%..%
%....%.....%
%...%.....%%
%....%%.%..%
%..........%
%.....%....%
%..........%
%..........%
%...%.P....%
%.......%..%
%.....%....%
%.%....%...%
%..........%
%%%%......%%
%..%...%...%
%..........%
%%.........%
%%%%%%%%%%%%
