
%%%%%%%%%%%%
%..........%
%%.........%
%.........%%
%......%...%
%..........%
%..........%
%..%......%%
%...%....%.%
%...%.%....%
%.....P....%
%%...%.....%
%..........%
%.%........%
%..........%
%..........%
%%....%.%..%
%....%.%...%
%...%......%
%%%%%%%%%%%%