
%%%%%%%%%%%%
%          %
%.         %
%   .      %
% %        %
% .        %
%      . % %
%.%        %
%    %     %
%          %
%     P    %
%     %    %
%          %
%%%     %  %
%   %      %
%          %
%          %
%        % %
%          %
%%%%%%%%%%%%