
%%%%%%%%%%%%
%.......%%.%
%..........%
%.......%..%
%........%.%
%.....%....%
%%.........%
%.........%%
%%%........%
%......%...%
%.....P..%.%
%.%....%...%
%...%......%
%..........%
%.%......%.%
%......%...%
%%....%..%%%
%%..%%..%..%
%.....%....%
%%%%%%%%%%%%