
%%%%%%%%%%%%
%..........%
%.%.......%%
%....%.....%
%...%......%
%...%..%...%
%.%%%......%
%...%......%
%....%..%..%
%.......%..%
%.%...P%...%
%.....%....%
%..........%
%.%.%......%
%..%%%.....%
%..........%
%.........%%
%..........%
%.....%.%..%
%%%%%%%%%%%%