
%%%%%%%%%%%%
%%..%..%...%
%%.......%.%
%%..%......%
%......%...%
%..........%
%..........%
%..%....%..%
%%.%.......%
%..........%
%....%P....%
%....%..%%.%
%%...%.....%
%%......%..%
%..........%
%.......%..%
%......%.%.%
%..........%
%%.%.......%
%%%%%%%%%%%%