
%%%%%%%%%%%%
%  .      %%
%    .     %
% .     %  %
%     %    %
%          %
%       %% %
% %  ..    %
% %        %
%     % %  %
%%    P    %
%         %%
%          %
%  %       %
%  %       %
%      %   %
%        % %
%          %
%          %
%%%%%%%%%%%%