
%%%%%%%%%%%%
%   .      %
%.    .    %
%       %  %
%       .  %
%.%      % %
%     %%   %
%   %      %
%%         %
%          %
% %   P    %
%      %   %
%%    %% % %
%  %  %    %
%          %
%          %
%  %       %
%          %
%    %    %%
%%%%%%%%%%%%