
%%%%%%%%%%%%
%..........%
%...%%.....%
%..%.......%
%%.......%.%
%......%.%.%
%..........%
%....%.....%
%..........%
%..........%
%%....P%.%.%
%..%.......%
%..........%
%%%......%.%
%....%.....%
%....%....%%
%....%.%...%
%..........%
%%.........%
%%%%%%%%%%%%