
%%%%%%%%%%%%
%.........%%
%.%.%......%
%%.........%
%....%%....%
%...%%.....%
%.......%%.%
%..........%
%....%.....%
%....%.%...%
%....%P....%
%..........%
%..%.......%
%........%.%
%...%......%
%..........%
%..........%
%......%.%%%
%..........%
%%%%%%%%%%%%