
%%%%%%%%%%%%
%          %
%          %
%     .  % %
%   .      %
%    .     %
%  .   %   %
%  .    %% %
%   %      %
%  %       %
%     P    %
%          %
% %        %
%          %
%          %
%          %
%       %  %
%          %
%%      %  %
%%%%%%%%%%%%