
%%%%%%%%%%%%
%          %
%       .  %
%      %   %
%       . .%
%.  .      %
%         %%
%          %
%    %     %
%    %     %
%    %P    %
%%  %      %
%   %      %
%%     %% %%
%  %    %  %
%       % %%
%       %  %
%          %
%          %
%%%%%%%%%%%%