
%%%%%%%%%%%%
%..........%
%.....%....%
%........%.%
%..........%
%..........%
%.....%....%
%....%....%%
%...%......%
%%..%......%
%.....P...%%
%......%...%
%..%....%..%
%..........%
%....%.....%
%....%.%.%.%
%..%....%%.%
%..%.%%....%
%..........%
%%%%%%%%%%%%