
%%%%%%%%%%%%
%       .  %
%          %
%%     .   %
%%   .     %
% . .     %%
%    %     %
%   %      %
%%         %
%    %     %
%   % P  % %
%      %%  %
%         %%
%%         %
%          %
% % %   %  %
%          %
%        % %
%   %      %
%%%%%%%%%%%%