
%%%%%%%%%%%%
%  .   %   %
%          %
%     . %  %
% %.       %
%     .    %
% .        %
%    %     %
%   %      %
%          %
%     P    %
%          %
%%         %
%          %
%  %       %
%          %
%     % %  %
%   %      %
%          %
%%%%%%%%%%%%