
%%%%%%%%%%%%
%..........%
%..%.......%
%.%........%
%......%...%
%..........%
%......%...%
%..........%
%.......%..%
%..........%
%.....P%...%
%.......%..%
%%%....%...%
%....%..%..%
%..........%
%..........%
%..........%
%.......%.%%
%..........%
%%%%%%%%%%%%