
%%%%%%%%%%%%
%..........%
%........%.%
%......%...%
%.....%....%
%..........%
%..........%
%%%.......%%
%.....%.%..%
%..........%
%....%P....%
%%.........%
%..........%
%........%.%
%......%...%
%..........%
%....%.....%
%......%..%%
%..........%
%%%%%%%%%%%%