
%%%%%%%%%%%%
%..........%
%......%%..%
%..........%
%.........%%
%..........%
%........%.%
%%.........%
%.....%....%
%.........%%
%...%.P..%.%
%..........%
%..........%
%.....%..%.%
%%.%....%..%
%..........%
%..%.......%
%.....%..%.%
%..........%
%%%%%%%%%%%%