
%%%%%%%%%%%%
% .        %
%.         %
% .      . %
%      %   %
%          %
% .       %%
%      %   %
%          %
%        % %
%     P    %
%       %  %
%   %      %
%       %  %
%        % %
%    %     %
%          %
% %    %   %
% %        %
%%%%%%%%%%%%