
%%%%%%%%%%%%
%        . %
% %        %
%         .%
%.      %  %
%   %      %
%  ..      %
%        % %
%          %
%        % %
%     P    %
%      % % %
%   %      %
%     %    %
%%         %
%     % %  %
% %        %
%        % %
%          %
%%%%%%%%%%%%