
%%%%%%%%%%%%
%....%.....%
%%.%%......%
%..%.......%
%..........%
%..%.......%
%..........%
%.%........%
%..........%
%%.........%
%.....P..%.%
%..........%
%..%....%..%
%..........%
%..%.%.....%
%%.......%.%
%.%....%...%
%.........%%
%..%.......%
%%%%%%%%%%%%