
%%%%%%%%%%%%
%......%%.%%
%.%.....%..%
%..........%
%...%%.....%
%%..%......%
%..........%
%........%.%
%..........%
%..........%
%...%.P..%.%
%.%........%
%..........%
%..%%.%.%..%
%.%..%.....%
%..........%
%..........%
%.........%%
%.....%....%
%%%%%%%%%%%%