
%%%%%%%%%%%%
%      . ..%
%   %.  .  %
%       %  %
%          %
%     %    %
%    %   % %
%%         %
%         %%
%          %
%     P %  %
%     %    %
%          %
%         %%
%          %
%          %
%  %       %
%   %      %
%  % %     %
%%%%%%%%%%%%