
%%%%%%%%%%%%
%     .    %
%  . .    %%
%          %
% .        %
%         %%
%          %
%          %
%     %    %
%   %      %
%     P    %
%%    %    %
%   .      %
%          %
%%         %
%  %       %
%    %     %
%      %   %
%          %
%%%%%%%%%%%%