
%%%%%%%%%%%%
%     .    %
%          %
%          %
%          %
%          %
% . %  .   %
%       .. %
%     %  % %
%          %
%     P    %
%          %
%      %   %
%       %  %
% %        %
% %  %    %%
%          %
%    %     %
%          %
%%%%%%%%%%%%