
%%%%%%%%%%%%
%..........%
%......%...%
%..........%
%..........%
%%%..%.....%
%..........%
%..........%
%....%.....%
%...%......%
%..%..P....%
%........%.%
%..........%
%........%.%
%..........%
%......%.%.%
%..........%
%..........%
%%......%..%
%%%%%%%%%%%%