
%%%%%%%%%%%%
%%.....%%..%
%%.........%
%..%.......%
%..........%
%..........%
%........%.%
%....%.....%
%........%.%
%%.........%
%..%..P%...%
%.%........%
%..........%
%.....%.%..%
%%%......%.%
%..%%...%..%
%.%........%
%.....%....%
%..........%
%%%%%%%%%%%%