
%%%%%%%%%%%%
%          %
%  %. %    %
%       .  %
%          %
%   .   .  %
%         .%
%          %
%          %
%          %
%  %  P    %
%   %      %
%    %  %  %
%    %     %
%    %     %
% %        %
%          %
%     %    %
%         %%
%%%%%%%%%%%%