
%%%%%%%%%%%%
%         .%
%  .       %
%          %
% .      . %
%  .   %   %
%          %
%          %
%   %%   % %
%      %   %
%% %  P%  %%
%       %  %
%          %
%          %
%    %     %
%% % %     %
%         %%
%  %       %
%          %
%%%%%%%%%%%%