
%%%%%%%%%%%%
%          %
%  %  .    %
%          %
%          %
%    . %   %
%   .    . %
% .        %
%    %     %
%     %    %
%%    P %  %
%         %%
%          %
%          %
%          %
%          %
%   %  %   %
%       % %%
%          %
%%%%%%%%%%%%