
%%%%%%%%%%%%
%.         %
%    %  .. %
% .        %
%.    %    %
%          %
%%        %%
%          %
%     %  % %
%     %    %
%     P    %
%          %
% % %   %  %
%          %
%          %
%       %% %
%          %
%      %   %
% %        %
%%%%%%%%%%%%