
%%%%%%%%%%%%
%..%.......%
%....%%...%%
%..........%
%..........%
%..........%
%%.......%.%
%.....%....%
%...%......%
%..........%
%.%...P%...%
%...%%.....%
%...%......%
%%....%.%..%
%......%...%
%..........%
%..%....%..%
%..........%
%...%.....%%
%%%%%%%%%%%%