
%%%%%%%%%%%%
%.%......%.%
%......%%..%
%..%.......%
%...%......%
%....%..%..%
%%........%%
%..........%
%..........%
%%.........%
%.....P%...%
%.....%....%
%....%%....%
%%.........%
%....%.....%
%..........%
%..........%
%..........%
%.....%%...%
%%%%%%%%%%%%