
%%%%%%%%%%%%
%          %
%      .   %
%.         %
%          %
%.         %
%   .      %
%    %  .% %
%        % %
%    %     %
%   % P %  %
% %%%      %
%          %
%  %       %
%       % %%
%          %
%      %   %
%%         %
%     %    %
%%%%%%%%%%%%