
%%%%%%%%%%%%
%    %     %
%      %   %
%.        .%
%       .  %
% ..   %%  %
%        % %
%       %  %
%          %
%      %   %
%%%   P    %
%  %       %
%          %
%         %%
%          %
%          %
%          %
%         %%
%          %
%%%%%%%%%%%%