
%%%%%%%%%%%%
% %   .    %
%      .   %
%          %
%     %    %
%          %
%        %%%
%.   .     %
%          %
% .     %  %
%  %  P  % %
%          %
%          %
%     %    %
%          %
%     %  % %
%         %%
%%     %   %
%     %    %
%%%%%%%%%%%%