
%%%%%%%%%%%%
%..%.......%
%..........%
%...%...%%.%
%%.........%
%%.........%
%%.%.......%
%.%........%
%..........%
%...%%.....%
%.%...P....%
%..........%
%.......%..%
%..%.....%.%
%.......%..%
%...%......%
%.........%%
%.........%%
%%....%....%
%%%%%%%%%%%%