
%%%%%%%%%%%%
%.........%%
%....%.....%
%.%........%
%..........%
%..........%
%..%....%..%
%..%....%..%
%......%...%
%..........%
%.....P....%
%%......%%.%
%....%.....%
%%......%.%%
%......%...%
%..........%
%......%...%
%..........%
%..........%
%%%%%%%%%%%%