
%%%%%%%%%%%%
%%      .  %
%% . .     %
%       .  %
%      % . %
%        % %
%          %
%          %
%          %
%      %   %
%     P    %
% %     %  %
%          %
%%         %
%          %
%      %   %
%        % %
%          %
%%         %
%%%%%%%%%%%%