
%%%%%%%%%%%%
%.....%....%
%........%.%
%....%.....%
%..........%
%....%.....%
%......%...%
%.....%....%
%..%....%%.%
%%.........%
%.....P....%
%.%......%.%
%......%...%
%.....%.%..%
%..........%
%.%%.......%
%.....%....%
%.%%.%.....%
%..%...%...%
%%%%%%%%%%%%