
%%%%%%%%%%%%
%  .   .   %
%  .   %   %
%        . %
%. % %  %  %
%          %
%          %
%      %   %
%  %  %    %
%          %
%     P    %
%   %      %
%         %%
% %        %
% %        %
%          %
%         %%
%      %   %
%      %%  %
%%%%%%%%%%%%