
%%%%%%%%%%%%
%          %
%    ..    %
%          %
%          %
%%   %%    %
% % .      %
%.  %      %
%   .      %
%          %
%    %P    %
%          %
%%         %
%    %     %
%%         %
%         %%
%          %
%          %
%        % %
%%%%%%%%%%%%