
%%%%%%%%%%%%
%...%......%
%%.........%
%..........%
%..........%
%.......%..%
%.........%%
%..........%
%....%.....%
%..%.%.....%
%...%.P....%
%.%.....%..%
%..........%
%.........%%
%%.........%
%....%%....%
%.........%%
%..%.......%
%.%....%%.%%
%%%%%%%%%%%%