
%%%%%%%%%%%%
%...%......%
%...%......%
%....%.....%
%...%.....%%
%......%...%
%...%......%
%..........%
%..........%
%..%.......%
%..%..P....%
%...%......%
%......%.%.%
%...%......%
%..........%
%..%.......%
%..........%
%..........%
%%.%.......%
%%%%%%%%%%%%
