
%%%%%%%%%%%%
%..........%
%..........%
%%.........%
%%.%.%.....%
%..........%
%...%......%
%........%.%
%.......%..%
%..........%
%...%.P.%%.%
%..........%
%..........%
%%.........%
%.........%%
%.....%..%%%
%...%......%
%..%....%..%
%..%...%...%
%%%%%%%%%%%%