
%%%%%%%%%%%%
%          %
%.         %
%          %
%    %     %
%    .     %
%      .   %
%      .   %
%     .    %
%     %    %
%     P    %
%       %% %
% %      % %
% %        %
%     %    %
%          %
%        % %
%        % %
%  %     % %
%%%%%%%%%%%%