
%%%%%%%%%%%%
%..........%
%...%......%
%..........%
%..........%
%..........%
%...%%....%%
%.%.....%..%
%......%...%
%..%......%%
%.....P...%%
%..........%
%.%........%
%......%..%%
%..........%
%.%........%
%....%.....%
%..%.......%
%%%......%.%
%%%%%%%%%%%%