
%%%%%%%%%%%%
%      .   %
%.         %
%     % .  %
%          %
%  . .     %
%          %
% %    %%  %
%      % % %
%  %       %
%   % P    %
%%         %
%          %
%          %
%          %
%       %  %
%          %
%          %
%  %   %%  %
%%%%%%%%%%%%