
%%%%%%%%%%%%
%          %
%        % %
%          %
%          %
%  .   %   %
%         .%
%          %
%   .      %
%  .     . %
% %   P   %%
%   %     %%
%          %
%          %
%          %
%     %    %
%          %
%%        %%
%   %   % %%
%%%%%%%%%%%%