
%%%%%%%%%%%%
%........%.%
%%.........%
%...%..%.%.%
%..........%
%..........%
%..%.......%
%....%.....%
%..........%
%..........%
%...%.P....%
%..%......%%
%....%....%%
%...%...%..%
%.......%..%
%....%.....%
%..%%.%....%
%..........%
%%.........%
%%%%%%%%%%%%