
%%%%%%%%%%%%
%      .   %
% .    %   %
% %  .   . %
%          %
%          %
% .        %
%       % %%
%%         %
%          %
% %%  P    %
%          %
% %        %
%         %%
%          %
%        % %
%    % %   %
%   %      %
%          %
%%%%%%%%%%%%