
%%%%%%%%%%%%
%    . . . %
%.    .    %
%         %%
%  %       %
%          %
%      %   %
%    %     %
%%         %
% %        %
%     P    %
%  %      %%
%%         %
%          %
%          %
%      %   %
%         %%
%          %
%          %
%%%%%%%%%%%%