
%%%%%%%%%%%%
%..        %
%%    .    %
%    .     %
%          %
%  .       %
%  %   %   %
%    % %   %
%          %
%          %
%  %  P    %
%  %       %
%        % %
%          %
%%         %
%    %  %  %
%        %%%
%       %  %
%   %      %
%%%%%%%%%%%%