
%%%%%%%%%%%%
%     %  % %
% %        %
%          %
%      ..  %
% %        %
%    %  %  %
%    .    %%
%     .  % %
%%  .   %  %
%     P    %
%          %
%        % %
%      %   %
%          %
%          %
%          %
%  %       %
%          %
%%%%%%%%%%%%