
%%%%%%%%%%%%
%..........%
%......%..%%
%........%.%
%..%...%...%
%..........%
%....%.%...%
%..%.%.....%
%.....%....%
%..........%
%.....P....%
%%.........%
%..........%
%....%.....%
%..........%
%..........%
%....%.....%
%......%...%
%.......%..%
%%%%%%%%%%%%