
%%%%%%%%%%%%
%        ..%
%  .    .  %
%         .%
%      %   %
%          %
%          %
%          %
%    %     %
%          %
%     P    %
%          %
%         %%
%          %
% %        %
%          %
%          %
%          %
%      %  %%
%%%%%%%%%%%%