
%%%%%%%%%%%%
%..%.......%
%...%.....%%
%%..%%%....%
%..%.%..%..%
%..........%
%..........%
%.....%....%
%......%...%
%..........%
%....%P..%.%
%....%.....%
%.....%....%
%..........%
%......%...%
%.......%..%
%.%........%
%..........%
%..........%
%%%%%%%%%%%%