
%%%%%%%%%%%%
%...%.....%%
%......%...%
%..........%
%.........%%
%..%%......%
%..........%
%.....%%...%
%.......%..%
%..........%
%.....P....%
%..........%
%%....%..%.%
%.......%..%
%..........%
%..........%
%..........%
%........%.%
%...%......%
%%%%%%%%%%%%