
%%%%%%%%%%%%
%%........%%
%%........%%
%..........%
%..%..%....%
%....%.%.%.%
%..........%
%..........%
%....%....%%
%..........%
%.....P....%
%.%........%
%.%.......%%
%.......%..%
%..........%
%.....%....%
%%.....%...%
%%.........%
%..........%
%%%%%%%%%%%%