
%%%%%%%%%%%%
%....%...%.%
%....%.....%
%........%.%
%%..%......%
%..%....%%.%
%.........%%
%..........%
%..........%
%.....%....%
%.....P....%
%...%.....%%
%.....%....%
%......%...%
%....%.....%
%...%......%
%..........%
%..........%
%...%......%
%%%%%%%%%%%%