
%%%%%%%%%%%%
%........%.%
%..........%
%......%...%
%...%..%...%
%..........%
%..%%%.%...%
%.%........%
%%.........%
%..........%
%..%..P....%
%......%%..%
%%%........%
%..........%
%%........%%
%...%.....%%
%..........%
%.......%..%
%.......%..%
%%%%%%%%%%%%