
%%%%%%%%%%%%
%        . %
%..        %
%          %
%      %   %
%    %     %
%          %
%          %
%     %  . %
% %     .  %
%     P %% %
%          %
%        %%%
%      %   %
%     %    %
%       %  %
%%       % %
%      %   %
%  %       %
%%%%%%%%%%%%