
%%%%%%%%%%%%
%..%.......%
%.%.%%.....%
%.......%..%
%.%.....%..%
%.......%..%
%..........%
%........%%%
%........%.%
%.......%%.%
%.....P%...%
%.%........%
%......%...%
%..%.......%
%..........%
%..........%
%..........%
%..........%
%..........%
%%%%%%%%%%%%