
%%%%%%%%%%%%
%      . . %
%  %       %
%     . .  %
%      % . %
%% %       %
%  %%      %
%          %
%   %      %
%    %  %  %
%%%   P    %
%  % %     %
%       %  %
%%         %
%  %       %
%          %
%          %
%%         %
%   %    % %
%%%%%%%%%%%%