
%%%%%%%%%%%%
%%......%..%
%..........%
%.........%%
%....%...%.%
%..........%
%..........%
%%......%..%
%...%%.....%
%....%.....%
%..%..P....%
%.%........%
%..........%
%.%........%
%....%%..%.%
%...%......%
%..........%
%...%......%
%.%........%
%%%%%%%%%%%%