
%%%%%%%%%%%%
%..%..%....%
%..........%
%....%.....%
%...%......%
%.........%%
%..........%
%..........%
%..........%
%........%.%
%.....P%%..%
%..........%
%.....%....%
%.........%%
%...%%.....%
%.....%...%%
%..........%
%..........%
%..........%
%%%%%%%%%%%%