
%%%%%%%%%%%%
%..........%
%.%..%.....%
%.......%..%
%..%.......%
%.........%%
%..........%
%..........%
%..........%
%..........%
%...%.P....%
%.%........%
%..........%
%%....%....%
%..........%
%....%..%..%
%..........%
%...%...%..%
%..........%
%%%%%%%%%%%%