%%%%%%%%%%%%%%%%%%%%
%....%........%....%
%.%%.%.%%%%%%.%.%%.%
%.%..............%.%
%.%.%%.%%  %%.%%.%.%
%......%  P %......%
%.%.%%.%%%%%%.%%.%.%
%.%..............%.%
%.%%.%.%%%%%%.%.%%.%
%....%........%....%
%%%%%%%%%%%%%%%%%%%%
