%%%%%%%%%%%%
%          %
%%%%%%.%%% %
%  % % % % %
%%%%.%.%.% %
%%   % %   %
%%.%.%.%%% %
%% % %   % %
%%.%%%%%%% %
%% %     % %
%%.%.%P%.% %
%% % % %   %
%%.%.%.%%% %
%% % %   % %
%%.%.%.%.% %
%%   % % % %
%%%%%%.%.% %
%%     % % %
%%%%%% %%% %
%%%%%%%%%%%%