
%%%%%%%%%%%%
%......%...%
%..%.%%....%
%.%....%%.%%
%........%.%
%.....%..%.%
%%.%.......%
%..%.....%.%
%..........%
%..........%
%..%..P....%
%.....%....%
%.%........%
%.%......%.%
%..........%
%..........%
%....%%.%%.%
%...%......%
%..........%
%%%%%%%%%%%%