
%%%%%%%%%%%%
%..%.......%
%.....%.%..%
%........%.%
%.%..%.....%
%....%...%.%
%.........%%
%.%....%...%
%..........%
%....%...%.%
%.....P....%
%..........%
%..........%
%..........%
%.%........%
%..........%
%..........%
%.....%....%
%..........%
%%%%%%%%%%%%