
%%%%%%%%%%%%
%..........%
%.....%....%
%.%.%......%
%..........%
%%........%%
%.........%%
%..........%
%..%.......%
%..........%
%.....P....%
%..........%
%%...%.....%
%.%........%
%%.........%
%.......%..%
%....%.....%
%%.........%
%%..%%.%%%.%
%%%%%%%%%%%%