
%%%%%%%%%%%%
%..........%
%%..%..%..%%
%..%.......%
%..........%
%..%......%%
%..........%
%..........%
%....%%....%
%.......%..%
%.....P....%
%..%.......%
%..........%
%.%........%
%.......%..%
%..........%
%.....%....%
%%.....%...%
%.%..%.....%
%%%%%%%%%%%%