
%%%%%%%%%%%%
%.....%....%
%.....%.%..%
%%........%%
%%.........%
%.....%..%.%
%.......%..%
%..........%
%..........%
%.%......%%%
%.....P....%
%...%......%
%...%.....%%
%.......%..%
%.......%.%%
%..........%
%.%........%
%..%.%.%..%%
%%....%..%.%
%%%%%%%%%%%%