
%%%%%%%%%%%%
%.%......%.%
%......%...%
%...%......%
%..........%
%........%%%
%....%.....%
%%%........%
%.%..%..%..%
%%.........%
%.%.%%P....%
%..........%
%...%....%.%
%..........%
%.....%....%
%%.........%
%.%........%
%.......%..%
%..........%
%%%%%%%%%%%%