
%%%%%%%%%%%%
%.%....%.%.%
%.........%%
%.%........%
%..........%
%.....%%..%%
%..%%......%
%..........%
%......%...%
%........%.%
%...%.P...%%
%..........%
%..........%
%..%..%...%%
%.%........%
%..........%
%..........%
%..%.......%
%..........%
%%%%%%%%%%%%