%%%%%%%%%%%%
%          %
%% %%% %%% %
%% % % % % %
%% %.%%%.% %
%% %     % %
%%%%.%%%.% %
%    %   % %
%%%%%%% %% %
%%         %
%%%% %P% % %
%    % % % %
%%.% % %%% %
%% % %     %
%%.% %%%%% %
%% %   % % %
%%.%%% % % %
%%   %   % %
%%%%%%%%%% %
%%%%%%%%%%%%
